{
  "R": {
    "R": "D",
    "P": "L",
    "S": "W",
    "D": "L",
    "W": "W"
  },
  "P": {
    "R": "W",
    "P": "D",
    "S": "L",
    "D": "L",
    "W": "W"
  },
  "S": {
    "R": "L",
    "P": "W",
    "S": "D",
    "D": "L",
    "W": "W"
  },
  "D": {
    "R": "W",
    "P": "W",
    "S": "W",
    "D": "D",
    "W": "L"
  },
  "W": {
    "R": "L",
    "P": "L",
    "S": "L",
    "D": "W",
    "W": "D"
  }
}